#####################################
#.      # #         #   #       #   #
##### # # # # ####### # # ### # # # #
#     # #   #   # #   # #   # # # # #
# ##### ####### # # ### ### # ### # #
#   #     # #       #     # #     # #
# # ##### # # ### ##### ### #########
# #   #       #       #     #       #
##### # ####### # ### # # ### # # ###
#             #   # # # # #   # #   #
# # ##### ### ##### # # # # ####### #
# # #     #           # #   #     #  
#####################################
